1111111111111111111111111
1000000010000000000210001
1011000010000000001110001
1111000010000000000210001
1001011110000000221110001
1001000010000000000000001
1001000000000000000000001
1001000000000000300000001
1001000000000000000000001
1001000011110000000000001
1001000010000000000000001
1000000010000000000000001
1000000010000404040400001
1000000010000000000000001
1000001110000404040400001
1000000000000000000000001
1000000000000000000000001
1111111111111111111111111