111111111
100000001
101120001
100000001
111111111
