1111111111111111111111111
1001000100010001000100011
1010101010101010101010101
1100010001000100010001001
1111111111111111111111111
1000000000000000000000001
1000000000040000000000001
1000000000000000000200001
1003000000000000000000001
1000000000000000000200001
1000000000040000000000001
1000000000000000000000001
1111111111111111111111111
1100000100000100000100001
1010001010001010001010001
1001010001010001010001011
1000100000100000100000101
1111111111111111111111111