1111111111111111111111111
1004400000000000000440001
1000440000000000004400001
1000044000003000044000001
1000004400000000440000001
1000000440000004400000001
1000000044000044000000001
1000000004400440000000001
1000000000444400000000001
1000000000444400000000001
1000000004400440000000001
1000000044000044000000001
1000000440000004400000001
1000004400000000440000001
1000044000000000044000001
1000440000000000004400001
1004400000000000000440001
1111111111111111111111111