1111111111111111111111111
1010101010101010101010101
1101010101010101010101011
1111111111111111111111111
1000000000000000001212121
1000000030000000001000001
1000000000000000001000001
1000000000000000001000001
1000000000000000001404041
1000000000000000001000001
1000000404040400001000001
1000000000000000001000001
1000000000000000001000001
1000000000000000000000001
1111111111111111111111111
1101010101010101010101011
1010101010101010101010101
1111111111111111111111111