1111111111111111111111111
1311111111111111111111001
1011111111111411111121001
1011111411111011111101001
1011141011111011111101001
1011101011141011111101001
1011101014101011111101001
1011101010101011111101111
1010000000000000000022111
1010000000000000000000111
1010000000000000000000111
1010000000000000000000111
1010000000000000000000111
1010000040000000000000111
1010000104100000000000111
1011111100111111111111111
1000000000000000000000001
1111111111111111111111111