111111111
100000001
101120041
100000301
111111111
